Date,Description,Amount (ZAR),Balance (ZAR),Category
2025-07-04,SASSA Pension,2315.0,2315.0,Other
2025-07-04,Funeral Policy,-100.0,2215.0,Other
2025-07-04,ATM Withdrawal,-1500.0,715.0,Other
2025-07-04,ATM Fee,-2.0,713.0,Administrative
2025-07-18,Local Shop Groceries,-300.0,413.0,Groceries
2025-07-18,ATM Withdrawal,-400.0,13.0,Other
